00000003003
11000001111
22110002222
22221012220
00022022200
01002022000
02100022113
00211100221
10000000022
21111111122