000000000
000000030
000000111
000001222
000012222
111122222
222222222
000000000