0000000000000001100
0000000000000001100
0000000000000001100
0011111110000111111
0011111110000111111
0000000000000000000
0000000000000000000
0000000000000000000
0111111111000111111
0111111111000111111