11000000000000000
11000000000001100
11000000000001100
11111110000001100
11111110000111100
00011000001111100
00000000011111100
00000000111111100
00000000111111100
00001100000000000
00001100000000000
00011100000000011
01111100110000111
01111111110000111
00001111111000111
00000111111000000