00000000000000000
00000000000000000
11111110000000000
11111110000110000
00011000001111000
00000000011111000
00000000111111100
00000000111111100
00001100000000000
00001100000000000
00001110000000011
01111111110000011
01111111100000111
00000111111000110
00000111111000000