11111111111110
11111111111110
00000000000110
00000000000110
11100000001111
11100000001111
00000000000000
00000000000000
00000000000000
00000000000000
00000000000000
00000000000000
00000000000000
00000000001111
00000000001111