00000000000000000
00000000000000000
11111110000000000
00222200000000000
00022000000111000
00000000001222000
00000000112222100
00000000022222000
00000000000000000
00001100000000000
00012210000000001
01122221110000012
02222222200000022
00000222211000000



