00000000000000000
00000000000000000
12222230000000000
bcc54cd0000130000
000bd000001a93000
0000000001a778000
000000001a7779300
000000000bccccd00
00000100000000000
00001200000000000
00002210000000001
01112221110000012
02222222200000122
00000222211000000