00000000000000000
00010000000000000
11111110000000000
00222200000110000
00022000001221000
00000000012222000
00000000122222100
00000100022222000
00000100000000000
00001200000000000
00012210000000001
01122221110000012
02222222200000122
00000222211000000