11000000000000
11000000000000
00000000000000
00000000000000
11000000000000
11000000000000
00000000000000
00000000000000
00000000000000
00011111111111
00011111111111
00001111111110