0000000011111100010000000
0000000011111100011000000
0000000011000001111000000
1111000011000000011111111
1111000011000111111111111
0000000011000111111000011
0000000011000000000000011
1111111111111111111111111
1111111111111111111111111