0000110000000000000000000000000000000
0000110000000000011000000000000000000
0000110000000000011000000000000000000
0000111111100000011000000000000000000
0000111111100001111000000000000000000
0000000110000011111000011111000000000
0000000000000111111000011111111111100
0000000000001111111000000111111111100
0000000000111111111000000000000001111
0000000011111100000000000000000001111
0000000011110000000000000000000000000
0000000000000000000000000000000000000
1110001111000000000000000000000000000
1110001111100000000000000000000000000
0000000011111000000110000000000000000
0000000001111000000110000000000000000