1111111111111
1111111111111
0000000000000
0000000000000
1110000000111
1110000000111